Hematología*
Hb: Hemoglobina
Hct: Hematocrito 
Leucocitos: Recuento Leucocitos
RAN totales: Neutrofilos totales
RAL totales: Linfocitos totales
MN totales: Monocitos totales
EOS totales: Eosinofilos totales
Plaquetas: Plaquetas (recuento)
VHS: vhs 
ELECTROLITOS PLASMÁTICOS*
Sodio: sodio
Potasio: potasio
Cloro: cloro
Ca Iónico: calcio Ionico
Calcio (corregido): calcio
Magnesio:MAGNESIO EN SANGRE
Fosforo: fosforo
PERFIL BIOQUÍMICO*
Ferritina: ferritina
Ácido Urico: acido urico
Amonio: AMONIO PLASMATICO
lactato: LACTATO EN SANGRE
LDH: lactato deshidrogenasa
Cetonemia: CETONEMIA CUANTITATIVA
Glucosa: glucosa
BUN:Nitrogeno ureico
Urea: urea
Albumina: albumina
PCR: Proteina c reactiva
Creatinina: Creatinina
vitamina B12: niveles vitamina b12
vitamina D: vitamina D 
PRUEBAS HEPÁTICAS*
Bil Total: bilirrubina total
Bil Directa: bilirrubina directa
FA: fosfatasa alcalina
GGT: ggt
GOT: got
GPT: gpt
BIOQUÍMICO PATOLOGÍAS*
Lipasa:lipasa en sangre
HORMONAS Y HEMOGLOBINA*
PTH:HORMONA PARATIROIDEA
TSH:HORMONA TIROESTIMULANTE (TSH)
Hba1c:HEMOGLOBINA GLICADA HbA1c
PERFIL LIPÍDICO*
Col total: colesterol total
LDL: colesterol ldl
HDL: colesterol hdl
Trigliceridos: Trigliceridos
CINÉTICA DEL FIERRO*
Fierro: fierro
U.I.B.C: u.i.b.c
T.I.B.C: t.i.b.c.
% Sat Transferrina: % saturacion de transferrina
transferrina: transferrina
VOLUMEN FILTRADO GLOMERULAR*
TP: porcentaje tp
INR: inr
TTPA: ttpa
Dimero D: Dimero D
GASES EN SANGRE*
pH: ph
PCO2: p co2
PO2: p o2
HCO3: hco3
Ex. Base: ex. Base
SatPO2: saturacion de o2
QUIMICAS DE ORINAS DE RECOLECCIÓN*
Proteina Orina 24h: PROTEINURIA x DIURESIS
PERFIL CARDIACO*
CK MB: CREATINKINASA MB (CK MB)
CK TOTAL: CREATINKINASA TOTAL (CK TOTAL)
Troponina: TROPONINA ULTRASENSIBLE
